####################
##P##T## # ####### #
        E    #     F
### #### ######Z####
######## ###########
######K   ##########
####################