####################
##P##T## # ####### #
        E      B   F
### #### ###P#######
######## ###########
######K   ##########
####################