####################
## ## ## # ####### #
        E          F
### #### ###########
######## ###########
#######   ##########
####################